aaaaaaaaaaaaaaaaaaaaaaaaaaaaaa
######!......!..####....##....
###.!..##!!##.!...#####....###
@..!.#######....!..##..!.!.!.F
###.#####.....###!.!!...!.!.!#
#...###########..##!!.########