aaaaaaaaaaaaaaaaaaaaaaaaaaaaaa
######!......!..####....##....
###.!..##!!##.!...#####....###
@..!.!######....!..##..!.!.!.#
#!..#####.....###!.!!...!.!.!.
#.!.###########..##!!.#######F